25,25
0 0 0 0 0 0 0 0 0 4 3 3 4 1 0 0 0 0 0 0 0 0 0 0 0
0 0 0 0 0 0 0 0 0 4 3 3 4 0 1 0 0 0 0 0 0 0 0 0 0
0 0 0 0 0 0 0 0 0 4 3 3 4 0 0 1 0 0 0 0 0 0 0 0 0
0 0 0 0 0 0 0 0 0 4 3 3 4 0 0 0 1 0 0 0 0 0 0 0 0
0 0 0 0 0 0 0 0 0 4 3 3 4 0 0 0 0 1 0 0 0 0 0 0 0
0 0 0 0 0 2 2 2 0 4 3 3 4 0 0 0 0 0 1 0 0 0 0 0 0
0 0 0 0 0 2 2 2 0 4 3 3 4 0 0 0 0 0 0 1 0 0 0 0 0
0 0 0 0 0 2 2 2 0 4 3 3 4 0 0 0 0 0 0 0 1 0 0 0 0
0 0 0 0 0 0 0 0 0 4 3 3 4 0 0 0 0 0 0 0 0 1 0 0 0
0 0 0 0 0 0 0 0 0 4 3 3 4 0 0 0 0 0 0 0 0 0 1 0 0
0 0 0 0 0 0 0 0 0 4 3 3 4 0 0 0 0 0 0 0 0 0 0 1 0
0 0 0 0 0 0 0 0 0 4 3 3 4 0 0 0 0 0 0 0 0 0 0 0 1
1 0 0 0 0 0 0 0 0 4 3 3 4 0 0 0 0 0 0 0 0 0 0 0 0
0 1 0 0 0 0 0 0 0 4 3 3 4 0 0 0 0 0 0 0 0 0 0 0 0
0 0 1 0 0 0 0 0 0 4 3 3 4 0 0 0 0 0 0 0 0 0 0 0 0
0 0 0 1 0 0 0 0 0 4 3 3 4 0 0 0 0 0 0 0 0 0 0 0 0
0 0 0 0 1 0 0 0 0 4 3 3 4 0 0 0 0 0 0 0 0 0 0 0 0
0 0 0 0 0 1 0 0 0 4 3 3 4 0 0 0 0 2 2 2 0 0 0 0 0
0 0 0 0 0 0 1 0 0 4 3 3 4 0 0 0 0 2 2 2 0 0 0 0 0
0 0 0 0 0 0 0 1 0 4 3 3 4 0 0 0 0 2 2 2 0 0 0 0 0
0 0 0 0 0 0 0 0 1 4 3 3 4 0 0 0 0 0 0 0 0 0 0 0 0
0 0 0 0 0 0 0 0 0 1 3 3 4 0 0 0 0 0 0 0 0 0 0 0 0
0 0 0 0 0 0 0 0 0 4 1 3 4 0 0 0 0 0 0 0 0 0 0 0 0
0 0 0 0 0 0 0 0 0 4 3 1 4 0 0 0 0 0 0 0 0 0 0 0 0
0 0 0 0 0 0 0 0 0 4 3 3 1 0 0 0 0 0 0 0 0 0 0 0 0